###########
#    P    #
#####     #
#O  O  O  #
# X   X   #
#     X   #
#         #
###########